###                             #########
#   ###########################       # #
# #### B                          # # # # #
# ############################# # # # #
#                                 # # # #
################################### # # #
#   ##                              # # #
# # ## ### ## ######### ############# # #
# #    #   ###                         #
# # ## ############################# # #
### ##                          #### # #
### ############## ##                # #
###             ##    # ############## #
###### ######## ####### # ############# #
###### ####             #             # #
A      ############################### #
